XXXXXXXXXXXXXXXXXXXXXXXXXX
XXXXXXXXXXX1223XXXXXXXXXXX
XXXXXXXXXXX7886XXXXXXXXXXX
XX12222231222252223XXXXXXX
XX455555678555555552223XXX
XX78888552345555556455613X
XXXXXXX455555555556455646X
XXXXXXX455555555556455556X
XX12222558945555556455679X
XX455555612555555558889XXX
XX78888897888858889XXXXXXX
XXXXXXXXXXX1226XXXXXXXXXXX
XXXXXXXXXXX7889XXXXXXXXXXX
XXXXXXXXXXXXXXXXXXXXXXXXXX