XXXXXXXXXXXXXXXXXXXXXXXXX
XXXXXXXXXX1223XXXXXXXXXXX
XXXXXXXXXX7886XXXXXXXXXXX
X12222231222252223XXXXXXX
X455555678555555552223XXX
X78888552345555556455613X
XXXXXX455555555556455646X
XXXXXX455555555556455556X
X12222558945555556455679X
X455555612555555558889XXX
X78888897888858889XXXXXXX
XXXXXXXXXX1226XXXXXXXXXXX
XXXXXXXXXX7889XXXXXXXXXXX
XXXXXXXXXXXXXXXXXXXXXXXXX